%%%%%%%%%%%%%%%%%%%%%%%%%
% % % % % % % % % % %  P%
% % % % % % % % % % % % %
% % % % % % % % % % % % %
% % % % % % % % % % % % %
%                       %
% % % % % % % % % % % % %
% % % % % % % % % % % % %
% % % % % % % % % % % % %
%.  % % % % % % % % % % %
%%%%%%%%%%%%%%%%%%%%%%%%%