%%%%%%%%%%%%%%%%%%
%          P     %
%      %         %
%                %
%      %         %
%                %
%.     %         %
%%%%%%%%%%%%%%%%%%
