%%%%%%%%%%%%%%%%%%%%
%                 P%
%                  %
%                  %
%                  %
%                  %
%.                 %
%%%%%%%%%%%%%%%%%%%%
