%%%%%%%%%%%%
%P         %
%%%%%%%%%% %
%         .%
%%%%%%%%%%%%
